2 2 6 5
00000000
00111110
11100011
10111101
10100001
11111111